####.####
#.#.....#
#.......#
#.....#.#
....@....
#.......#
#...#...#
#.......#
####.####